1111111111111
1P001000001C1
10C0001110001
1100001E00001
1111111111111