1111111
1P11111
1E01111
1111111