111111
1P1001
110001
10C001
1000E1
111111