111111
1E1001
110001
10C001
1000P1
111111