111111
1C1001
110001
10P001
1000E1
111111