111111
1E0001
110001
100001
1000P1
111111