111111
1E0001
110001
10C001
100001
111111