1111
1EC1
1T01
1001
1T01
1001
10T1
1001
1001
1001
1T01
1001
10P1
1111