1111111111
10000000P1
10000E0001
1000000001
100C000001
1111111111