1111111111111
10010000000C1
1000011111001
100011E100001
1P00000100001
1111111111111
