111111
100001
1P0001
1000C1
10E001
111111