1111111111111
10010000000E1
10C0011111111
1P0011C100001
10000000C0001
1111111111111
